1 delikatnie	90s
12345678	60s
2000s	2000s
2003	2000s
2008 fave	favorite
40 love	loved
40s 50s 60s	60s
40s 60s	60s
43365283	80s
50 and 60s	60s
50s 60s	60s
50s 60s singer	60s
50s and 60s	60s
50s and 60s influenced	60s
50s retro from the 70s	70s
50s to 80s	80s
60 80s	80s
60s	60s
60s 70s	60s
60s 70s 80s 90s 00s	80s
60s 70s and 80s	80s
60s 80s	60s
60s and 70s	60s
70 80s	80s
70s	70s
70s 80s	80s
70s 80s 90s	70s
70s and 80s	80s
70s and 80s grooves	80s
70s and 80s mix	80s
70s boz	70s
70s come 80s	80s
77davez 70s	70s
80 90s	90s
80s	80s
80s 70s	80s
80s 90s	80s
80s 90s 00s	90s
80s and 90s	80s
80s and 90s rnb	80s
80s tubeway army	80s
80s y 90s	90s
90s	90s
90s 00s	90s
90s to 2010	90s
a god singer	singer songwriter
a tdom	70s
aaaarrrgh	80s
abba singer	singer songwriter
abc hey citizen	american
abject	sad
absurd	funny
acerbic	funny
achter	2000s
achter mijn ogen	2000s
acid jazz	jazz
acid rock	rock
acid techno	electronica
acordeon	2000s
acoustic	acoustic
acoustic blues	acoustic
acoustic music	acoustic
acoustic rock	rock
acoustical	acoustic
acrid	intense
acrobatic	energetic
actor	singer songwriter
actor sing	singer songwriter
actor singers	singer songwriter
actress	singer songwriter
actress singer	singer songwriter
actress sings	singer songwriter
adamant	happy
adequate	good
admirable	great
admired	loved
adorable	sexy
adore lalah	loved
adored	loved
adventurous	dreamy
affectionate	funny
afi fave	favorite
african	british
afro american	american
agent steel	metal
aggressive	intense
agile	energetic
agonizing	sad
agreeable	happy
ahhhh los 90s	90s
ails fave	favorite
airy	dreamy
alabama	american
aleatoric music	jazz
algorithmic	electronic
alluring	sexy
alright	good
alterative	alternative
alternate	alternative
alternative	alternative
alternative country	alternative
alternative dance	dance
alternative folk	folk
alternative hip hop	alternative rock
alternative metal	alternative rock
alternative pop	alternative rock
alternative punk	alternative rock
alternative rock	alternative rock
amaze fave	favorite
amazed	happy
amazin 90s	90s
amazing	awesome
amber	dark
ambient	electronica
ambient dub	electronica
ambient music	electronica
ambient pop	pop
ambient techno	electronica
ambient trance	electronica
ambitious	energetic
america the 70s	70s
american	american
american primitive guitar	american
amiable	energetic
amigosan	70s
amorous	romantic
amusing	funny
anarchic	energetic
anarcho punk	punk
anathema family	party
anatolian rock	rock
ancillary	alternative
andino	80s
andrex	90s
androgynous	sexy
angeles	british
angelic	dreamy
anglo irish	british
anglo saxon	british
angry	sad
angsty	melancholic
anguished	sad
animo	70s
annoying	funny
anos 80s	80s
anti folk	folk
anxious	happy
apathetic	sad
ape loves	loved
apolitical	energetic
appalachian folk	folk
appalled	sad
appreciated	loved
appreciative	happy
apprehensive	happy
april love	loved
arab pop	pop
arabic pop	pop
arduous	intense
arena rock	rock
argentine rock	rock
arizona	american
arkansas	american
armenian	american
arpeggiated	melancholic
arriba canada	british
art pop	pop
art punk	punk
art rock	rock
artist	singer songwriter
artist abba	singer songwriter
artist editors	singer songwriter
artist fave	favorite
artist vs poet	singer songwriter
artiste	singer songwriter
artiste bio	singer songwriter
artsy	dreamy
arty	dreamy
as artist	singer songwriter
ashamed	sad
asia	british
asia goth	british
asian	american
asian american jazz	american
assertive	energetic
associations love	loved
assured	happy
astonished	happy
astounding	awesome
astute	energetic
atmospheric black metal	metal
atonal	melancholic
atrocious	sad
attractive	beautiful
atypical	intense
audiovisual	electronic
aural	acoustic
ausinks	80s
aussie	british
aussie christmas	british
aussies	british
australian	british
australian country music	british
australian hip hop	british
australian pub rock	rock
austrian	british
autumnal	melancholic
avant garde jazz	jazz
avant garde metal	metal
avant garde music	jazz
avant garde pop	pop
avivaldi	70s
awake	calm
awed	happy
awesome	awesome
awful	sad
awkward	funny
aymees fave track	favorite
aziza	60s
bababa	2000s
babe	sexy
bad	good
baleful	haunting
balkan pop	pop
ballet	dance
balmy	cool
bamboo band	metal
band hero	singer songwriter
bangin 70s	70s
banjo	jazz
baroque music	jazz
baroque pop	pop
bashful	energetic
bass music	jazz
bassline	electronica
bavaria	2000s
bawdy	funny
bband fave	favorite
bbc	british
beatboxing	electronica
beatific	dreamy
beauteous	beautiful
beautiful	beautiful
beautiful music	beautiful
bebop	jazz
been love	loved
beige	dark
belgium 80s	80s
believable	funny
beloved	loved
best	good
better	good
beutiful	beautiful
bewildered	sad
bewitching	dreamy
big	great
birmingham	british
bitchy	sexy
bitter	sad
bittersweet	sad
bizarre	funny
bizarro	funny
bjoerk	80s
blach shinnie likl bwai	80s
black	dark
black metal	metal
blackened death metal	metal
blackish	dark
bleak	sad
blip hop	pop
blissful	dreamy
blistering	intense
bloc	party
blond	sexy
blonde	sexy
blue	dark
blue eyed	dark
blue eyed soul	soul
bluegrass	jazz
blues	jazz
blues rock	rock
bluish	dark
bnp	british
bodacious	sexy
bohemian	romantic
boisterous	energetic
bold	energetic
bolton	british
bonkers	funny
boobs singer	singer songwriter
boogie rock	rock
boogie woogie	jazz
bootylicious	sexy
bop	jazz
bop hop	jazz
boring	funny
boston	american
boston america	american
boston love	loved
boy and girl singers	singer songwriter
boy band	singer songwriter
boy girl band	singer songwriter
boy girl bands	singer songwriter
boy girl harmonies	singer songwriter
boy in love	loved
boy love	loved
boy loves guitar	loved
boy singer	singer songwriter
boy singers	singer songwriter
brainy	sexy
brash	energetic
brasil singer	singer songwriter
brassy	mellow
brazil	british
brazilian	american
brazilian jazz	jazz
breakbeat	electronica
breakbeat hardcore	punk
breakcore	electronica
breakneck	intense
breathtaking	beautiful
breathy	melancholic
breezy	dreamy
brenda fassie vuli ndlela remix	2000s
breton music	jazz
brian loves	loved
bright	dark
brill building pop	pop
brilliant	great
bring bac 80s n 90s	90s
brisk	intense
british	british
british blues	british
british invasion	british
brits	british
broad	intense
broken hearted	sad
brooding	melancholic
brown	dark
bruising	intense
brunette	sexy
brutal	intense
brutal death metal	metal
bryan	british
bstatd	70s
bubblegum dance	dance
bubblegum pop	pop
bulgy	dark
bummed	sad
buoyant	energetic
burlesque	dance
burly	energetic
burnin love	loved
busty	sexy
but love	loved
butch	sexy
buy list 80s	80s
buzzy	sexy
c love	loved
cabaret	jazz
cabinet	party
cajun music	jazz
california	american
california 60s	60s
california love	loved
california mf	american
california u	american
callous	sad
calm	calm
calming	calm
campy	funny
canada	british
canada love	loved
canadian	british
cape jazz	jazz
capoeira music	jazz
captivating	beautiful
carefree	mellow
careful	good
caribbean	american
caribic jamaikan singer	singer songwriter
carnatic music	jazz
carribean	british
catalyst	instrumental
catchy	funny
cathartic	haunting
cbs	american
cd 60s	60s
cd 70s	70s
cd 90s	90s
cd sammlung	2000s
celebrity singers	singer songwriter
cello	jazz
cello rock	rock
celtic metal	metal
celtic punk	punk
celtic rock	rock
cerebral	energetic
cereza699 fave	favorite
ch4nfr41s3	80s
chamber jazz	jazz
chamber pop	pop
champagne sax	jazz
chaotic	intense
charismatic	energetic
charito	90s
charming	beautiful
chaste	romantic
chatty	funny
cheeky	funny
cheerful	mellow
cheerless	melancholic
cheery	mellow
cheesy	funny
cheney	american
chic	sexy
chicago soul	soul
child singers	singer songwriter
childhood fave	favorite
childhood loves	loved
childish	funny
childlike	dreamy
children of love	loved
chill	chill
chilling	haunting
chillout	chillout
chillwave	electronica
chilly	cool
chinese	british
chinese pop	pop
chinese rock	rock
chirpy	energetic
chivalrous	romantic
choppy	intense
choral	jazz
chordal	acoustic
chris	british
christian	american
christian alternative	alternative
christian black metal	metal
christian electronic music	electronic
christian metal	metal
christian punk	punk
christian rock	rock
chrome	metal
chrome depot	metal
chuffed	happy
chunky	sexy
chvelle	2000s
ciala wyginanie	2000s
cielo andino	80s
city pop	pop
clannad singer	singer songwriter
classic	classic rock
classic blues	classic rock
classic female blues	classic rock
classic jazz	jazz
classic rock	classic rock
classical music	jazz
classy	beautiful
claustrophobic	haunting
clever	funny
clinton	american
clique	party
cloudy	dark
cloying	dreamy
cohesive	energetic
coital	romantic
cold	hot
college gf fave	favorite
colorful	beautiful
combative	energetic
comedic	funny
comedy	funny
comedy rock	indie rock
comely	sexy
comfortable	happy
comforting	haunting
comical	funny
compelling	great
competent	good
complacent	happy
complicated	intense
computer	electronic
computer bubblegum	electronic
computer core	electronic
computerized	electronic
conceited	sad
concentrated	intense
concerted	intense
confident	happy
conflicted love	loved
confrontational	energetic
congenial	energetic
connie francies 60s	60s
conscience	soul
conscious	happy
considerate	happy
consoling	haunting
constant	intense
constructive	intense
contemplative	mellow
contemporary folk	folk
contemporary jazz	jazz
contented	happy
continuous	intense
contralto	singer songwriter
convenient	alternative
conventional	alternative
cool	cool
cool jazz	jazz
corny	funny
coronation street	party
country folk	folk
country pop	pop
country rock	rock
country soul	soul
courageous	energetic
cowboy psychedelia	punk
cpe bach	2000s
cpe time	2000s
craberries	70s
crafty	energetic
crampton	80s
crazy	funny
creative	energetic
credited	instrumental
creepy	funny
crestfallen	happy
crossover jazz	jazz
crossover thrash metal	metal
crucial	instrumental
cruel	sad
crust punk	punk
cry for love	loved
cuban	american
curious	sad
cute	funny
cyber metal	metal
cyp 90s	90s
czech	american
dad guitar	singer songwriter
dads fave	favorite
daffy	funny
daft	funny
dainty	beautiful
dance	dance
dance music	dance
dance pop	pop
dance punk	dance
dance rock	rock
danceable	electronica
dancfloor	90s
dancin tunes	oldies
dancing	dance
dandy	favorite
danish	american
dank	dark
dark	dark
dark ambient	dark
dark cabaret	dark
dark electro	dark
dark folk	folk
dark jazz	jazz
dark pop	pop
dark psytrance	dark
dark wave	dark
darkened	dark
darkish	dark
darkwave	electronica
darling	favorite
daughter love	loved
daunting	intense
davis	american
daydreams of love	loved
dazzling	beautiful
deannas fave	favorite
death metal	metal
death rock	rock
debonair	sexy
decent	good
deep	intense
deep soul	soul
deerhof	2000s
deft	energetic
deirdre loves	loved
dejected	happy
delectable	beautiful
delicate	beautiful
delicious	beautiful
delighted	happy
delightful	beautiful
delikatnie i subtelnie	90s
demir demirkan	90s
demmies 80s mix	80s
democratic	party
demure	sexy
dense	intense
depeched	80s
deprecating	funny
depressing	sad
depressive black metal	metal
desert rock	rock
desolate	haunting
desperate	happy
despicable	sad
despondent	sad
destructive	intense
devastated	sad
devastating	sad
dewy	dreamy
dexys	80s
diego	american
different	alternative
difficult	intense
diffuse	intense
digital	electronic
dipdet	80s
dire	sad
dirty	hot
disappointed	happy
disappointing	sad
disbelieving	happy
disco polo	dance
disconcerting	sad
discordant	melancholic
disgusted	sad
disgusting	sad
disheartened	sad
disillusioned	sad
dismal	sad
disney	american
disney pop	pop
disorienting	haunting
dispirited	sad
disrespectful	sad
dissonant	melancholic
distinct	intense
distraught	sad
distressing	sad
disturbing	haunting
ditzy	sexy
diva	singer songwriter
diva diva	singer songwriter
diva house	singer songwriter
diva remix	singer songwriter
diva tracks	singer songwriter
divine rock	rock
dixieland jazz	jazz
dizzying	intense
dj tunes	electronica
dj zinc	metal
djing	chillout
do adore	loved
do for love	loved
doctor love	loved
doleful	melancholic
dolorous	melancholic
dominican	american
doom metal	metal
doomy	melancholic
dopey	funny
dorky	sexy
dour	melancholic
downbeat	melancholic
downtempo	electronica
dr israel	american
dramatic	intense
dreadful	sad
dream esque	dreamy
dream pop	pop
dreamlike	dreamy
dreamy	dreamy
dreary	dreamy
drippy	dreamy
driwe driwe	60s
droll	funny
drone metal	metal
druggy	punk
drugs 60s	60s
dry	hot
ds60s 70s	70s
dub techno	electronica
dubstep	electronica
dulces 90s	90s
dulcimer	jazz
dumb	funny
durham	american
dusky	dreamy
dusty	dark
dutch	british
dutch jazz	jazz
dynamic	energetic
e loves	loved
eager	happy
earths	metal
earthy	mellow
ease	calm
ebullient	energetic
ecellent singer	singer songwriter
ecstatic	happy
eddy 80s	80s
edgy	sexy
eerie	haunting
eery	haunting
effective	good
effeminate	sexy
effervescent	energetic
effortless	energetic
ego	soul
egypt	british
egyptian	british
ekova singer	singer songwriter
ekt	2000s
elated	happy
eldritch	haunting
electric folk	folk
electrical	electronic
electrifying	energetic
electro	electronica
electro funk	electronica
electro hop	electronica
electro punk	punk
electroclash	punk
electromagnetic	electronic
electronic	electronic
electronic art music	electronic
electronic body music	electronic
electronic dance	electronic
electronic music	electronic
electronic rock	rock
electronica	electronica
electropop	electronica
elegaic	melancholic
elegant	beautiful
elegiac	melancholic
eloquent	energetic
elvirisms fave	favorite
elvis love	loved
embarrassed	sad
embarrassing	sad
emcee	singer songwriter
emilou harris	90s
emma loves this	loved
emo	punk
emo pop	pop
emo rap	punk
emocore	punk
emotive	haunting
empathetic	energetic
enamored	loved
enchanted	beautiful
enchanting	beautiful
endearing	funny
endless	intense
energetic	energetic
energized	energetic
english	british
engrossing	haunting
enigmatic	dreamy
enjoyable	awesome
enjoyed	loved
enlightening	funny
enormous	great
enrigue iglesias	70s
entertaining	funny
enthralling	haunting
enthusiastic	energetic
entrancing	dreamy
enveloping	haunting
envious	happy
epic	intense
eric singer	singer songwriter
erotic	romantic
erudite	energetic
escapist	romantic
esque	dreamy
essential	instrumental
essential rock	rock
estetica	80s
ethereal	dreamy
ethereal pop	pop
ethereal wave	dreamy
euphoric	energetic
european	british
evocative	haunting
ex love	loved
excelent	good
excellent	good
exceptional	great
excited	happy
exciting	awesome
excruciating	intense
exemplary	great
exhausting	intense
exhilarated	happy
exhilarating	awesome
existential	melancholic
existentialist	melancholic
existing	alternative
expansive	intense
expensive	alternative
experimental music	electronica
experimental noise	acoustic
experimental pop	pop
experimental rock	rock
explsive	80s
expressive	energetic
exquisite	beautiful
extensive	intense
extraordinary	great
extreme	intense
extreme metal	metal
exuberant	energetic
fabulous	beautiful
falsetto	acoustic
family act	party
family is love	loved
family love	loved
famous	favorite
fantastic	awesome
fantastical	dreamy
fascinating	funny
fashionable	sexy
fatalistic	melancholic
fav	favorite
fav 80s	80s
fav 90s	90s
fav artist	singer songwriter
fav of faves	favorite
fav singer	singer songwriter
fave	favorite
fave 2	favorite
fave 2006	favorite
fave 2008	favorite
fave 3	favorite
fave 4	favorite
fave 70s	70s
fave 80s	80s
fave accident	favorite
fave arema 80s	80s
fave artist	favorite
fave artist 1	favorite
fave artists	favorite
fave artists ever	favorite
fave band	favorite
fave belle tracks	favorite
fave chembros	favorite
fave echobelly	favorite
fave ever	favorite
fave faves	favorite
fave kandi	favorite
fave lines	favorite
fave rnb	favorite
fave rnb tracks	favorite
fave rotire	favorite
fave siouxsie	favorite
fave tori	favorite
fave track	favorite
fave tracks	favorite
fave tracks 2	favorite
fave trax	favorite
fave traxs	favorite
fave tunes	oldies
fave tunez	favorite
fave vibes	favorite
faves	favorite
favorite	favorite
favorito loves loves	loved
favy fave and the faves	favorite
fearful	sad
fearless	energetic
fearsome	intense
feisty	energetic
femail singer	singer songwriter
femal artist	singer songwriter
femal singer	singer songwriter
femcee	singer songwriter
feminine	sexy
ferocious	intense
fervent	energetic
fever	chill
fevered	intense
feverish	intense
fiberglass	metal
fiddler	singer songwriter
fierce	intense
fiery	energetic
fiesta en ibizaaa	60s
finest	great
fingerstyle guitarist	singer songwriter
firas love	loved
fistful of steel	metal
flamboyant	energetic
flamenco	jazz
flamenco jazz	jazz
flamenco rumba	dance
flashy	sexy
flawless	awesome
flexible	alternative
flighty	dreamy
flippant	funny
flirty	sexy
floaty	dreamy
florid	melancholic
flossin 80s style	80s
flugelhorn	jazz
fm 70s	70s
fmera fave	favorite
foggy	dark
folk	folk
folk hop	folk
folk metal	folk
folk music	folk
folk pop	pop
folk punk	folk
folk rock	rock
folkloric	folk
folksy	mellow
folktronica	electronica
fond	loved
foolish	sad
for love	loved
forceful	energetic
foreboding	haunting
forgotten	sad
forlorn	sad
formidable	intense
fortunate	happy
foundational	instrumental
foxy	sexy
fragrant	beautiful
france rnb	british
frank	intense
franstalig	70s
frantic	intense
freak folk	folk
freaky	funny
free folk	folk
free jazz	jazz
freewheeling	energetic
french	british
french canadian	british
french pop	pop
frenetic	energetic
frenzied	intense
frightened	sad
frightening	haunting
frilly	sexy
frisky	sexy
frost	chill
frosty	cool
fruitful	good
fruity	mellow
fuck america	british
fuji music	jazz
fun	funny
funeral doom metal	metal
funereal	melancholic
funk	electronica
funk metal	metal
funk rock	rock
funk soul	soul
funkiest	favorite
funky	dreamy
funnier	funny
funniest	funny
funny	funny
furious	happy
fusion jazz	jazz
future jazz	jazz
g60s and 70s	70s
gabiii	70s
gabis 80s	80s
garage punk	punk
garage rock	rock
gauzy	dreamy
gb1 singer	singer songwriter
geeky	sexy
geje xdd	2000s
gelid	chill
gemma love	loved
gene loves	loved
gene loves jezebel	loved
genial	mellow
genre	indie
genre 80s	80s
genteel	mellow
gentle	mellow
georgia	american
georgia gibbs	american
german	british
german folk music	folk
ghastly	sad
ghostly	haunting
gifted	energetic
giggly	sexy
gigiola	2000s
gimmicky	funny
girl and boy singers	singer songwriter
girl band	singer songwriter
girl boy band	singer songwriter
girl love	loved
girl singer	singer songwriter
girl singers	singer songwriter
girlie	sexy
girlish	sexy
girls love	loved
girly	sexy
gitara i spiew	70s
glad	happy
glam	sexy
glam metal	metal
glam punk	punk
glam rock	rock
glamorous	sexy
glamourous	sexy
glasgow uk	british
gleaming	beautiful
gleeful	sad
glib	funny
glistening	beautiful
glitch pop	pop
glittering	beautiful
glittery	sexy
glockenspiel	electronica
gloomy	melancholic
glorious	beautiful
glum	sad
goeie 80s	80s
gogen solncev	70s
good	good
good for nothing	good
good natured	good
goofy	funny
gordon	british
gorgeous	beautiful
gospel music	jazz
got love	loved
goth cello	punk
goth hop	punk
goth pianist	singer songwriter
goth psychedelia	punk
gothic metal	metal
gothic rock	rock
gothy	sexy
gotta love	loved
govi guitarist	singer songwriter
graceful	beautiful
gracious	happy
grammy nominee	singer songwriter
grateful	happy
gravar	2000s
gray	dark
great	great
greatest	great
greece	british
grieving	sad
grim	sad
grindcore	punk
gripping	haunting
gritty	energetic
groove metal	metal
grooving guitar	acoustic
groovy	dreamy
grouchy	sad
group	party
grrrl bands	punk
grrrl riot	punk
grt track frm 70s	70s
gruesome	haunting
grumpy	sad
grunge	punk
gta	british
guesswhat	2000s
guitar artists	jazz
guitar girl	singer songwriter
guitar girls	dance
guitar guru	singer songwriter
guitar hero	singer songwriter
guitar hero 80s	80s
guitar hero iii	instrumental
guitar hero on tour	singer songwriter
guitar legend	singer songwriter
guitar maestro	singer songwriter
guitar remix	electronica
guitar singer	singer songwriter
guitar slinger	singer songwriter
guitar virtuosi	jazz
gus 80s	80s
gusty	intense
gutsy	energetic
guy girl harmonies	singer songwriter
guy singer	singer songwriter
guy singers	singer songwriter
gymnastic	dance
gypsy jazz	jazz
gypsy punk	punk
haiti	american
haitian	american
halvbra	80s
hampshire	american
handsome	beautiful
happier	happy
happiest	happy
happinezz	2000s
happy	happy
happy go lucky	happy
happy hardcore	happy
hard	good
hard rock	rock
hardcore metal	metal
hardcore punk	punk
harlem heat	chill
harmonic	acoustic
harmonica blues	jazz
harmonious	energetic
harrowing	haunting
harsh	intense
hated	loved
hateful	sad
haunted	haunting
haunting	haunting
hawaii	american
hawt	sexy
hawt 80s	80s
haze	chill
hazy	dark
hc brazil	british
hea artist	singer songwriter
heady	dreamy
healthy	energetic
heartbreaking	sad
heartbroken	sad
heartening	sad
heartfelt	haunting
heartland rock	rock
heartless	sad
hearty	mellow
heat haze	chill
heated	hot
heavenly	beautiful
heavy	intense
heavy hearted	intense
heavy metal	metal
heavy rock	rock
hectic	intense
heinous	sad
hellcat artist	singer songwriter
hellish	sad
hello love	loved
helluva	awesome
helpful	good
hemsedal 90s	90s
henry	british
hesitant	happy
hh usa	american
hi love	loved
hideous	sad
hilarious	funny
hilton	british
hindu	british
hip hop soul	soul
hippy	punk
hispanic	american
histrionic	melancholic
holographic	electronic
honest	good
honkytonk tunes	jazz
hop	pop
hopeful	happy
hopeless	sad
horny	sexy
horrendous	sad
horrible	sad
horrid	sad
horrific	sad
horrifying	sad
horror punk	punk
hot	hot
hot blooded	hot
hotter	hot
hottest	hot
houd van dit	2000s
houston	american
hrrr	90s
htl	2000s
hues corporation	party
huge	great
humbled	happy
humbling	sad
humor	funny
humorist	singer songwriter
humorous	funny
humourous	funny
hunky	sexy
hurrah for the 80s	80s
hurtful	sad
hush	calm
hushed	haunting
hybrid	alternative
hyperactive	energetic
hypnotic	melancholic
hypocritical	sad
hysterical	sad
hyypo loves	loved
i am the 80s	80s
i empire	british
i imagine love	loved
ian	british
ian carey	british
ian love	loved
ian no1	british
icelandic	british
iconic	beautiful
icy	dark
idaho	american
ideal	good
idiosyncratic	melancholic
idiotic	funny
idol guitarist	singer songwriter
idyllic	beautiful
ie love	loved
ignorant	sad
illinois	american
illogical	sad
illuminating	haunting
imaginative	energetic
imitosis	70s
immaculate	beautiful
immense	great
impactful	great
impassioned	energetic
impatient	happy
impeccable	good
impetuous	energetic
impish	energetic
important	great
impressed	happy
impressionist music	jazz
impressionistic	dreamy
impressive	awesome
improvisational	jazz
impulsive	energetic
in america	american
in love	loved
in meiner sammlung	2000s
inane	funny
incessant	intense
incomparable	great
incomprehensible	sad
incredible	awesome
incredulous	sad
indescribable	awesome
india irie	british
indian	british
indian pop	pop
indie	indie
indie folk	indie
indie music	indie
indie pop	pop
indie rock	indie rock
indifferent	sad
indignant	sad
individualistic	energetic
indo rock	rock
indonesian pop	pop
indulgent	dreamy
industrial death metal	metal
industrial metal	metal
industrial rock	rock
industrious	energetic
indy band	indie
indy uk	british
inevitable	sad
inexplicable	sad
influenced by the 60s	60s
influential	energetic
inimitable	funny
inky	dark
innovative	energetic
inquisitive	energetic
insejn	2000s
insensitive	sad
insightful	funny
insignificant	sad
inspiration to love	loved
inspirational	energetic
inspirations of love	loved
inspiring	great
instrumental	instrumental
instrumental jazz	instrumental
instrumental rock	rock
instrumentalist	singer songwriter
integral	instrumental
intelligent	energetic
intelligent dance music	dance
intense	intense
intensifying	intense
intensive	intense
interactive	electronic
interesting	funny
interminable	intense
intimate	romantic
intricate	intense
introspective	melancholic
inventive	energetic
invigorated	energetic
involved	instrumental
iowa	american
iran	american
iranian	american
iranian pop	pop
iraq	american
iraqi	american
irish	british
irish folk	folk
iron	metal
ironic	sad
irreplaceable	great
irrepressible	energetic
irresistible	energetic
irresponsible	sad
irreverent	funny
ish	dreamy
islam	british
islamic	british
ismo	2000s
israel	american
israeli	british
italian	american
italo dance	dance
italy	british
its america	american
izle	2000s
izolejszyn	70s
j pop	pop
j rock	rock
j4	2000s
jailbait	sexy
jam rock	rock
james	british
jammin sax	jazz
jamming guitar	acoustic
jammy	mellow
jangle pop	pop
jangling	haunting
jangly	melancholic
january2010 nyc	british
japan	british
japanese	american
japanese pop	pop
jarring	haunting
jaunty	dreamy
jays love	loved
jazz	jazz
jazz blues	jazz
jazz funk	jazz
jazz fusion	jazz
jazz metal	jazz
jazz rap	jazz
jazz rock	rock
jazzy	jazz
jbd	60s
jealous	sad
jermsama	80s
jesus children of america	american
jewish	american
jews	british
jfk	british
jimmi	60s
jimmi diggin cats	60s
jimmi hendrix	60s
jimmi page	60s
jimmi rodgers	60s
jimmi van m	60s
jitterbug	dance
jittery	calm
jjmarik1986	2000s
joannies fave	favorite
john hyatt	british
johnny love	loved
jolting	haunting
jordan	american
jose	american
jovial	mellow
joyful	energetic
joyous	energetic
js fave	favorite
jt mexico	american
jubilant	happy
jumpen	90s
junkie artists	singer songwriter
k pop	pop
kai loves	loved
kaleidoscopic	dreamy
kansas	american
kaos 90s	90s
kappe 1704	2000s
kapullo23	2000s
kawaii metal	metal
kcs fave	favorite
kent love	loved
key	instrumental
kickass	awesome
kickass tastic	awesome
kid artist	singer songwriter
kid singer	singer songwriter
kinetic	energetic
kinky	sexy
kissable	sexy
kiwi rock	rock
kizz fave	favorite
kko love	loved
klasyka xdd	2000s
klezmer	jazz
kobiecy spiew	70s
kooky	funny
korean	american
korean pop	pop
koti	60s
kraut from 90s	90s
krautrock	electronica
krezi stilus	60s
krist novoselic	90s
krist novoselich	90s
ks 80s	80s
la india	british
laconic	mellow
lady bands	singer songwriter
lady love	loved
lady singers	singer songwriter
lady writer	singer songwriter
ladylike	sexy
lampchop	80s
languid	dreamy
languorous	dreamy
lank	dark
lap steel	metal
latin	british
latin american	american
latin jazz	jazz
latin pop	pop
latin rock	rock
latin soul	soul
latino	american
laughable	funny
laurel loves	loved
lead singer	singer songwriter
legendary	great
legends 80s	80s
leggy	sexy
legislature	party
lemmiklood	70s
lengthy	intense
lesbo love	romantic
leviye kongi	2000s
lgbt	american
lieblied	70s
life in 60s	60s
lifeless	sad
light	dark
light rock	rock
likable	funny
likeable	energetic
liked	loved
lilting	melancholic
lindy hop	dance
line dance	dance
lingering	intense
lional hampton	2000s
lisbon	american
lissom	sexy
lithe	energetic
lively	energetic
lms artist	singer songwriter
loathsome	sad
logical	happy
lol america	american
lonely	sad
loopy	dreamy
los angeles	american
los angeles usa	american
lotta love	loved
louisiana swamp pop	pop
lounge music	jazz
lousy	good
lovable	funny
love	loved
love anamor	loved
love and nostalgia	loved
love artist	loved
love balads	loved
love breeds	loved
love buy	loved
love california	loved
love can	loved
love child	loved
love cky	loved
love cousin	loved
love crimes	loved
love em	loved
love eminem	loved
love exists	loved
love experience	loved
love fav	loved
love for art	loved
love for chi	loved
love for dummies	loved
love for evrybody	loved
love goran	loved
love gum	loved
love gwen	loved
love her	loved
love him	loved
love inc	loved
love ittttt	loved
love jarvis	loved
love kelly	loved
love korn	loved
love krove	loved
love love this	loved
love me	loved
love msp	loved
love needing	loved
love no love	loved
love october	loved
love of friends	loved
love of loves	loved
love poems	loved
love rammstein	loved
love regrets	loved
love rh	loved
love rnb	loved
love scene	loved
love sessions	loved
love silhouette	loved
love stories	loved
love styrofoam	loved
love sucks	loved
love surfjan	loved
love that died	loved
love the	loved
love the friends	loved
love them	loved
love themed	loved
love these	loved
love this	loved
love this love	loved
love this singer	loved
love to hate	loved
love to love	loved
love to sing	loved
love tracks	loved
love tunes	loved
love wolfs	loved
love women	loved
love y	loved
love ya	loved
love you	loved
love you save	loved
loveable	funny
loved	loved
lovelier	beautiful
loveliest	beautiful
lovelorn	melancholic
lovely	beautiful
lovers rock	rock
loves	loved
loves gons	loved
loves her	loved
loves jesus	loved
loves melody	loved
loves soongs	loved
loves theme	loved
loving	loved
lp koti	60s
lucky	happy
ludicrous	sad
lugubrious	melancholic
lulling	haunting
luminous	beautiful
luomo	80s
luscious	beautiful
lush	beautiful
lusty	sexy
luxurious	beautiful
lyrical	melancholic
m a tes souhaits	80s
m2nosk	70s
m9co	80s
macabre	haunting
madcap	funny
maddening	sad
maestro	singer songwriter
magical	beautiful
magnetic	electronic
magnificent	beautiful
maia	american
mainstream jazz	jazz
mainstream rock	indie rock
majestic	beautiful
make love	loved
maks fave	favorite
malawian jazz	jazz
mama love	loved
mambo	dance
mammagamma	80s
mandarin pop	pop
manic	melancholic
mannish	sexy
manual	electronic
marimba	jazz
mark artist	singer songwriter
marvelous	great
marxen mix	90s
massive	intense
masterful	awesome
math rock	rock
maudlin	melancholic
mazzzzy	70s
md charmy	90s
me love	loved
meaningful	great
mechanical	electronic
medieval folk rock	folk
medieval metal	metal
medieval music	jazz
mediocre	good
meditative	melancholic
melancholic	melancholic
melancholy	melancholic
mellifluous	mellow
mellow	mellow
melodic	acoustic
melodic black metal	metal
melodic death metal	metal
melodic dubstep	electronica
melodic hardcore	punk
melodic music	jazz
melodic rock	indie rock
melodic trance	electronica
melodies	electronica
melodious	mellow
melodramatic	melancholic
melody dnb	electronica
melody heart	soul
memorable	funny
memphis soul	soul
merciless	intense
mercurial	energetic
merf loves	loved
merry	happy
mesmerizing	dreamy
messy	sad
metal	metal
metalcore	punk
metallic	metal
metallic hardcore	metal
methodical	energetic
meticulous	intense
mew love	loved
mexican	american
mexican pop	pop
mexican rock	rock
miachael	2000s
michigan	american
mild	intense
milky	dark
minded	energetic
minimal	intense
minimal wave	intense
minimalist music	jazz
minnesota	american
mischievous	funny
miserable	sad
missouri	american
misty	dreamy
mm love	loved
mobile	electronic
modal jazz	jazz
modern rock	classic rock
monochromatic	dreamy
monumental	great
monumental dance	dance
mood ruff	chill
mood trippy	melancholic
moody	dreamy
moog80	80s
moony	dreamy
mopey	dreamy
mordant	melancholic
morose	melancholic
mortified	sad
moshing	punk
mossy	dark
mournful	melancholic
mp1	80s
mulen rusz	60s
multifaceted	energetic
murder love	loved
murky	dark
muscular	energetic
muse esque	dreamy
mushroom jazz	jazz
music drama	dance
musical	jazz
muskrat love	loved
muslim	british
muzotrip	90s
my 2000s	2000s
my 60s 70s childhood	70s
my brazil	british
my fav singer	singer songwriter
my fave	favorite
my italy	british
my love	loved
my loves	loved
my savior loves	loved
mysterious	haunting
mystical	dreamy
na dolek	60s
na mietowo	60s
nadal	american
najbolje	80s
namesake	favorite
nas america	american
naughty	sexy
nay 80s	80s
nazi	british
nbc	american
ne 90s	90s
neat	beautiful
neco	80s
negro	american
nejno	80s
neo classical metal	metal
neo goth	punk
neo rockabilly	punk
neo soul	soul
neoclassical metal	metal
neoclassical music	jazz
nerd love	loved
nerdy	sexy
nervous	happy
nervy	energetic
neu 80s	80s
new	alternative
new instrumental	instrumental
new orleans jazz	jazz
new pop	pop
new romantic	romantic
new weird america	american
newgrass	jazz
nfl	american
nice	good
nicest	beautiful
nicole fave	favorite
nigerian	british
nightmarish	haunting
nihilistic	melancholic
nitra loves	loved
nivia	70s
no 1 60s	60s
no hashhash	70s
no love	loved
no singer	singer songwriter
no1	british
no1 uk	british
no1 usa	british
no29 uk	british
no6 uk	british
no6 usa	american
no84 uk	british
noel loves	loved
noise pop	pop
noise rock	rock
noisy	energetic
nonsensical	funny
nordysk	2000s
norrk ping	70s
northern soul	soul
norway love	loved
norwegian	british
nostalgic	melancholic
noteworthy	great
nu brazil	british
nu jazz	jazz
nu metal	metal
nu soul	soul
nuanced	intense
nubile	sexy
nyc	american
nylon	metal
nylon guitar	metal
o melhor dos 90s	90s
oao	80s
obama	american
obesity	70s
objective	instrumental
obnoxious	funny
obsessive	intense
occult rock	rock
ocd love	loved
odd	funny
oddball	funny
offbeat	funny
oh love	loved
ohio	american
oklahoma	american
oldest	favorite
oldies	oldies
ominous	haunting
omnicore	2000s
on love	loved
ongoing	intense
online	electronic
online bcc	electronic
online love	loved
online rules	electronic
oonag s	70s
opaque	dark
operatic pop	pop
opinionated	funny
opposition	party
optimistic	happy
opulent	beautiful
orchestra	jazz
orchestral	jazz
orchestral jazz	jazz
oregon	american
orginal artist	singer songwriter
oriental metal	metal
orton	american
osc25	90s
oshkosh	70s
oshkosh bistro	70s
otherworldly	dreamy
othesun23	80s
our love	loved
outstanding	great
ouvri a qualquer hora	70s
overjoyed	happy
overwhelming	intense
owen tate	american
p4k love	loved
pac	american
pacify	calm
pacy	energetic
pagan metal	metal
pagan rock	rock
pained	sad
painful	sad
painstaking	intense
pakistan	british
pale	dark
papapapa	80s
papitos 80s	80s
party	party
passable	good
passionate	energetic
pathetic	sad
peace punk	punk
peacful bliss	happy
pedro erazo	80s
peerless	great
penguin love	loved
penn	american
pensive	melancholic
pep love	loved
peppery	mellow
peppy	mellow
perceptive	funny
percussion	jazz
percussion genius	jazz
percussionist	singer songwriter
percussive	acoustic
perfect	good
perhaps love	loved
perilous	intense
perky	sexy
perplexed	happy
persistent	intense
petite	sexy
petrified	sad
phantasmagoric	haunting
phenomenal	great
phil 80s	80s
philadelphia soul	soul
philippine	american
philly soul	soul
pianist	jazz
piano	jazz
piano blues	jazz
piano rock	rock
pick artist	singer songwriter
picker poet	singer songwriter
picturesque	beautiful
pimp pianist	singer songwriter
piniwiis	2000s
pinoy pop	pop
pinoy rock	rock
pirations	80s
pithy	funny
pitiful	sad
pivotal	instrumental
placid	mellow
plaintive	melancholic
plangent	melancholic
plastic	metal
plattdeutsch	2000s
playful	funny
pleasant	mellow
pleased	happy
pleasing	good
plucky	energetic
poet	singer songwriter
poet singer	singer songwriter
poetic	melancholic
pogo love	loved
poignant	haunting
polished	energetic
political	party
poofy	sexy
poor	good
pop	pop
pop folk	pop
pop metal	pop
pop music	pop
pop punk	pop
pop rap	pop
pop rock	rock
pop soul	pop
pop up	pop
popular	favorite
porny	sexy
portentous	haunting
positive	good
post metal	metal
post punk	punk
post rock	rock
power metal	metal
power pop	pop
powerful	energetic
ppl	british
pragmatic	energetic
praiseworthy	good
pray for love	loved
praying for love	loved
precious	beautiful
precocious	energetic
predictable	intense
preferred	alternative
pretentious	funny
priceless	beautiful
prickly	intense
primary	alternative
pristine	beautiful
privileged	happy
prodigious	energetic
productive	energetic
profound	intense
progressive death metal	metal
progressive electronic	electronic
progressive folk	folk
progressive house	party
progressive metal	metal
progressive pop	pop
progressive rock	rock
proper	good
proud	happy
psy love	loved
psych folk	folk
psychedelic	electronica
psychedelic folk	folk
psychedelic pop	pop
psychedelic rock	rock
psychedelic trance	electronica
psychlist	80s
psychobilly	punk
pub rock	rock
puerto rican	american
puffy	dark
pulsating	intense
punchy	mellow
punk	punk
punk blues	punk
punk cabaret	punk
punk jazz	punk
punk rap	punk
punk rock	indie rock
purgraues haar	90s
purposeful	energetic
putiferio	80s
puzzling	sad
quaint	beautiful
queen diva	singer songwriter
queen esque	sexy
quenched	calm
quiet	calm
quiet storm	calm
quik	2000s
quirky	funny
quizzical	funny
quotable	funny
racy	sexy
radcliffe	80s
radiant	beautiful
rafa	british
raga rock	rock
ragga	electronica
ragtime	jazz
rambunctious	energetic
rangy	energetic
raouldukejr10	2000s
rap metal	metal
rap rock	rock
rapid	intense
ratyi de kiraly d	90s
raucous	energetic
raul	british
raunchy	sexy
raw rock	rock
reagge love	loved
real	great
realistic	intense
rebellious	energetic
rechazo	90s
recital	dance
red	dark
reflexive	intense
refreshing	mellow
regal	beautiful
reggae	jazz
reggae fusion	electronica
reggin	60s
regime	party
regretful	sad
regrettable	sad
relentless	intense
remarkable	great
remember	loved
remember 70s	70s
remembered	loved
remembers	loved
remix	electronica
remix diva	singer songwriter
remixes	electronica
remorseful	happy
renaissance music	jazz
rending	haunting
renewable	alternative
renewed	intense
renox	80s
repetitive	intense
republican	party
resentful	sad
resilient	energetic
resolute	energetic
resonant	haunting
respectable	good
responsible	instrumental
restful	mellow
retro france	american
retro love	loved
revolting	sad
rfm 80s	80s
rhythmical	energetic
rica	american
rico love	loved
ridiculous	funny
riemuhevi	2000s
riger	80s
riot grrrl	punk
risque	sexy
riveting	haunting
rnb 90s	90s
rnb love	loved
rnb remix	electronica
rnb sax	jazz
rnb singer	singer songwriter
robot love	loved
robust	intense
rock	rock
rock and roll	rock
rock opera	rock
rock steady	rock
rockabilly	punk
rokimpaa	70s
role	instrumental
romance	romantic
romantic	romantic
romantic classical	romantic
roots rock	rock
roots rock reggae	rock
rotten	sad
rough	good
rousing	haunting
rubettes	60s
rubin carter	american
rueful	melancholic
rufus love	loved
rumba	dance
russian	british
russian pop	pop
rustic	mellow
sab 70s	70s
sab 80s	80s
saccharine	dreamy
sad	sad
saddening	sad
samba	dance
samba rock	rock
sammlung	2000s
samsky loves	loved
san franscisco	60s
sandstorm js16 remix	80s
sapphic	romantic
sappy	dreamy
sarcastic	funny
sardonic	funny
sassy	sexy
satiric	funny
satirical	funny
satisfied	happy
satisfying	happy
saturday love	loved
saucy	sexy
saudi	british
savage	intense
savvy	energetic
sax	jazz
sax genius	jazz
sax love	jazz
sax melody	jazz
saxmax	70s
saxophonist	jazz
say love	loved
scandalous	sad
scared	sad
scary	sad
scenic	beautiful
schmaltzy	melancholic
schnaps	2000s
schrollis childhood fave	favorite
scorching	hot
scots	british
scottish	british
scottish baroque music	jazz
scrappy	energetic
screamo	punk
scrumptious	beautiful
sebastian tellier	70s
sebastien tellier	70s
sebastien tellier kilometer	70s
secondary	alternative
seductive	sexy
sejt	2000s
selfless	energetic
senseless	sad
sensible	good
sensitive	intense
sensual	sexy
sensuous	sexy
sentimental	melancholic
sepulchral	haunting
serbian	british
serene	mellow
serious	intense
set dance	dance
severe	intense
sexi love	loved
sexiest	sexy
sexxx ay	70s
sexy	sexy
sf rubettes	60s
shadowy	dark
shaken	calm
sharp	intense
sharp witted	funny
sheepish	happy
shimmering	dreamy
shimmery	dreamy
shiny	beautiful
shiver	chill
shivery	haunting
shock rock	rock
shocked	sad
shocking	sad
shoegaze	electronica
shoegazer	electronica
showy	beautiful
sickening	sad
significant	great
silly	funny
similar	alternative
simmering	intense
simmons	american
simply fave	favorite
simply love	loved
singapore	british
singer	singer songwriter
singer actor	singer songwriter
singer and actress	singer songwriter
singer circus	singer songwriter
singer francaise	singer songwriter
singer from thursday	singer songwriter
singer guitarist	singer songwriter
singer luv	singer songwriter
singer songwriter	singer songwriter
singing	dance
sinister	dark
sitar	jazz
sizzling	hot
ska	punk
ska punk	punk
skate punk	punk
skillful	energetic
slack key guitar	instrumental
sleazy	sexy
sleek	sexy
sleepless	sad
slinky	sexy
slowcore	electronica
sludge metal	metal
slut tastic	sexy
slutty	sexy
sly	funny
smarmy	funny
smiling	happy
smoochy	romantic
smooth jazz	jazz
smooth soul	soul
smutty	sexy
snappy	funny
snarky	funny
snazzy	sexy
snide	funny
sobering	sad
society	party
soft	hot
soft rock	rock
solemn	sad
solid	good
somber	haunting
sombre	melancholic
sonic	acoustic
sooth	calm
soothed	calm
soothing	mellow
sophisti pop	pop
soporific	melancholic
soppy	dreamy
sordid	sad
sorrowful	sad
sorrowing	sad
sorry	sad
soul	soul
soul blues	soul
soul jazz	soul
soul music	soul
soulful	mellow
southern metal	metal
southern rock	rock
southern soul	soul
space age pop	pop
space rock	rock
spanish	british
sparkling	beautiful
sparkly	sexy
spectacular	beautiful
speechless	happy
speed metal	metal
spellbinding	dreamy
speluny	80s
spiew	70s
spirit heart	soul
spirited	energetic
spiteful	sad
splendid	beautiful
spontaneous	energetic
spooky	haunting
sporadic	intense
sporty	sexy
sprightly	energetic
spritely	energetic
spunky	sexy
square dance	dance
sreamgrind	60s
standard	alternative
stark	haunting
startling	haunting
stately	beautiful
stavs fave	favorite
stax 70s	70s
steady	energetic
steamy	sexy
steel guitar	metal
steel guitars	metal
steel puls	metal
steel pulse	metal
steel wheels	metal
steely	intense
stellar	good
steph loves	loved
stern	calm
stiff	intense
stingy	good
stinky	sad
stir	chill
stoner metal	metal
stoner rock	indie rock
stormy	intense
strange	sad
strassenmusik	80s
street punk	punk
stressful	intense
strident	intense
strong	good
studio ghibli	party
studious	energetic
stunning	beautiful
stupendous	awesome
stupid	funny
style council	party
stylish	sexy
suave	sexy
sube animo	70s
sublime	beautiful
subtle	intense
successful	instrumental
suckerlove	2000s
sues fave	favorite
sufi music	jazz
sufi singer	singer songwriter
sullen	melancholic
sultry	sexy
summery	dreamy
sumptuous	beautiful
sun rise	chill
sunday tunes	oldies
sunny	dreamy
sunshine pop	pop
sunshine thuggery	chill
sunshiny	dreamy
superb	great
superior	good
surf instrumental	instrumental
surf pop	pop
surf rock	rock
surfer girl	singer songwriter
surfy	mellow
surprised	happy
surreal	funny
surrealistic	dreamy
suspenseful	haunting
svelte	sexy
svengali	singer songwriter
swamp pop	pop
swamp rock	rock
swanky	sexy
swedish	british
sweet	dreamy
swift	intense
swing music	jazz
switch	alternative
swizz heat	chill
swoony	dreamy
sydney charts 70s	70s
sydney charts 80s	80s
sydney charts 90s	90s
sylvan	beautiful
symphonic	jazz
symphonic black metal	metal
symphonic metal	metal
symphonic rock	rock
synth funk	electronica
synth pop	pop
synthpop	electronica
syrian	british
syrupy	dreamy
tactile	electronic
taiwanese pop	pop
talented	energetic
talkative	energetic
tame	calm
tamil	british
tango	dance
tangy	mellow
tasteful	beautiful
tastic	awesome
taut	intense
taxims fave	favorite
team emilou	90s
tearful	sad
teary	happy
tech	electronic
technical death metal	metal
technical metal	metal
techno	electronica
techno bass	electronica
technological	electronic
teddy love	loved
teen pop	pop
tejano music	jazz
tellier	70s
temazoooooooo	90s
temper	calm
temperature	chill
tenacious	energetic
tense	intense
tepid	intense
terceiro	60s
terrible	sad
terrific	great
terrified	sad
terrifying	haunting
texas artist	american
textural guitar	acoustic
thai pop	pop
thankful	happy
thaw	chill
the 80s people didnt know	80s
the clash 80s	80s
the craberries	70s
the love	loved
the rubettes	60s
the who goes 90s	90s
thick	dark
this love	loved
thoughtful	energetic
thoughtless	sad
thrash metal	metal
thrilled	happy
thrilling	awesome
throb	singer songwriter
thug love	loved
thunderous	intense
tibetan pop	pop
tichirrius	2000s
tiesto a gravar	2000s
timeless	beautiful
tin	metal
tired	sad
titillating	sexy
tkck fave	favorite
to america	american
to love	loved
toby love	loved
tokyo	british
tomas dvorak	2000s
tommy peoples	american
topless	sexy
torch singer	singer songwriter
torchy	melancholic
torturous	sad
touchable	beautiful
tough	good
trad jazz	jazz
traditional	alternative
traditional pop music	pop
tragic	sad
trance	electronica
tranquil	beautiful
transformational	instrumental
transgresivo	60s
transgressive	romantic
transitional	alternative
trashy	sexy
traumatic	sad
tremendous	great
tremulous	melancholic
trendy	sexy
tres bon 80s	80s
tribal house	party
trii	60s
trip rock	rock
trippy	dreamy
trippy dnb	electronica
trite	funny
triumphant	happy
troubling	sad
tseuq 80s	80s
tumultuous	intense
tuneful	melancholic
tunesmith	singer songwriter
turbo folk	folk
turbulent	intense
turkish	american
turkish pop	pop
turntablism	electronica
twee	indie
twee pop	pop
twila	70s
twinkly	dreamy
types of love	loved
tyrstrtgtres	60s
u2 80s	80s
uber fave	favorite
ufc	american
ugly	sad
uk	british
uk brits	british
uk goth	british
uk hardcore	british
uk heroes	british
uk invaders	british
uk love	loved
uk no1	british
uk ok	british
uk rick hop	british
uk rnb	british
uk singer	singer songwriter
uk undie	british
ulali	2000s
ulalume 70s 80s	80s
ulalume 80s	80s
ultrasonic	electronic
un toque andino	80s
unbearable	sad
unbeatable	awesome
unbelievable	awesome
unbridled	intense
uncaring	sad
uncertain	happy
uncomfortable	sad
uncompromising	intense
unconventional	energetic
undignified	sad
uneasy	sad
unending	intense
unforgettable	awesome
unforgivable	sad
unforgiving	intense
unfortunate	sad
unhappy	happy
unhurried	mellow
unimpressed	happy
unimpressive	good
uninhibited	energetic
unkind	sad
unnerving	haunting
unorthodox	energetic
unpleasant	sad
unplugged guitar	acoustic
unprecedented	intense
unpredictable	intense
unpretentious	mellow
unreal	awesome
unrelenting	intense
unrequited	romantic
unsatisfied	happy
unspeakable	sad
untamed	beautiful
unusual	intense
upbeat	energetic
uplifting	haunting
urban folk	folk
urban jazz	jazz
us singer	singer songwriter
usa	american
usa uk	british
useful	good
user fave	favorite
utah	american
valkyeriex loves	loved
vampy	sexy
vapid	dreamy
vaporous	dark
vaudeville	jazz
velvety	mellow
venezuela	american
verizon	american
vermont	american
versatile	energetic
viajando	2000s
viajando al cosmos	2000s
vibrant	energetic
vicious	intense
victims of love	loved
vietnam	american
vigorous	intense
viking metal	metal
vindictive	sad
violin battle	dance
visceral	intense
vital	instrumental
vivacious	energetic
vivid	haunting
vixen	sexy
vocal	instrumental
vocal jazz	jazz
volatile	intense
voluptuous	sexy
vote	party
voyuer	90s
wacky	funny
wailing	haunting
wakejszyn	80s
walmart	american
waltz	dance
warm	cool
washington	american
watery	dark
we love	loved
we love the 80s	80s
weary	sad
weepy	melancholic
weird	funny
welsh	british
wet	hot
whacky	funny
what a singer	singer songwriter
whimsical	dreamy
white	dark
white hot	hot
who loves	loved
who needs love	loved
widespread	intense
wieza melancholii	60s
wigan	british
windswept	beautiful
wino kobiety i spiew	70s
winsome	dreamy
wireless	electronic
wiry	energetic
wisconsin	american
wise	good
wispy	dreamy
wistful	melancholic
witch house	party
witchy	sexy
with love	loved
with theryl	80s
witney houston	american
witty	funny
wizard rock	rock
wny	70s
woeful	sad
womanly	sexy
women artist	singer songwriter
wonderful	great
wondrous	beautiful
wonky pop	pop
woodsy	mellow
woodwind	jazz
wooo eoeoeo ohhhh	70s
wop	jazz
word america	american
word artist	singer songwriter
wordless	melancholic
worldbeat	jazz
worldly	romantic
worrying	sad
worthwhile	good
wrenching	haunting
wretched	sad
writer	singer songwriter
wry	funny
wv	british
ww2	british
x clan	party
xdd	2000s
xm	american
xnzn	2000s
yacht rock	rock
yes america	american
ylintu	60s
ymt	80s
yo pop	pop
york	british
you love	loved
your love	loved
youthful	energetic
yummy	sexy
zany	funny
zesty	mellow
zexy	60s
zimbabwe	american
zinc	metal
zionist	american
zippy	dreamy
zu hause	60s
zydeco	jazz
